x;x;x;x;x;x;x;x;x;x;x;x;x;x;x;x;x;x;W;W;W;W;W;W;W;W;W;W;W;W;W;W;W
W;W;W;W;W;W;W;W;W;W;W;W;W;W;W;W;W;W;W;x;x;x;x;W;W;x;x;x;x;x;x;x;W
W;x;x;x;x;x;x;x;x;x;B;B;x;x;x;x;x;W;W;x;x;x;B;x;B;B;B;x;W;x;x;x;W
W;x;P;x;x;x;B;x;W;x;x;x;x;x;I;x;x;B;B;x;x;B;x;B;x;B;x;W;W;x;S;x;W
W;x;x;x;x;x;x;x;x;x;B;B;x;x;x;x;x;W;W;x;x;x;B;x;B;B;B;x;W;x;x;x;W
W;W;W;W;W;W;W;W;W;W;W;W;W;W;W;W;W;W;W;x;x;x;x;W;W;x;x;x;x;x;x;x;W
x;x;x;x;x;x;x;x;x;x;x;x;x;x;x;x;x;x;W;W;W;W;W;W;W;W;W;W;W;W;W;W;W