W;W;W;W;W;W;W;W;W;W;W;W;W;W;W;W;W;W;W;W
W;P;x;x;B;W;x;x;B;x;x;x;x;x;x;x;x;x;x;x
W;x;I;x;B;x;B;x;B;B;x;x;x;x;x;x;x;x;x;x
W;x;x;x;B;x;x;B;B;x;x;x;x;x;x;x;x;x;x;x
W;B;B;B;x;B;B;x;B;x;x;x;x;x;x;x;x;x;x;x
W;W;x;x;B;B;x;B;x;x;x;x;x;x;x;x;x;x;x;x
W;x;B;x;B;x;B;x;B;x;x;x;x;x;x;x;x;x;x;x
W;x;x;B;x;B;x;x;B;x;x;x;x;x;x;x;x;x;x;x
W;B;B;B;B;x;B;B;x;x;x;x;x;x;x;x;x;x;x;x
W;x;B;x;x;x;x;x;x;x;x;x;x;x;x;x;x;x;x;x